[
    {
        "nr": 1,
        "name": "Back and forth",
        "map": [
            [0,0,0,0,0,0,0,0,0,0],
            [0,10,11,11,11,11,11,11,12,0],
            [0,20,1,1,1,1,1,1,22,0],
            [0,23,1,1,1,1,1,1,22,0],
            [0,20,1,1,1,1,1,1,22,0],
            [0,20,1,1,1,1,1,1,22,0],
            [0,30,11,11,11,11,11,11,32,0],
            [0,0,0,0,0,0,0,0,0,0]
        ]
    }
]
